################################################################################
#..............................................................................#
#..............................................................................#
#....ooooooooooooooooooooooooooooooooooooooooooooooooooooooooooooooooo.........#
#....ggggggggggggggggggggggggggggggggggggggggggggggggggggggggggggggggg.........#
#....ggggggggggggggggggggg....D......D......D....ggggggggggggggggggggg.........#
#....ggggggggggggggggggggg.......................ggggggggggggggggggggg.........#
#....OOOOOOOOOOOOOOOOOOOOOooooooooOOOOOOOooooooooOOOOOOOOOOOOOOOOOOOOO.........#
#............o...........................................o........O............#
#....O.............o..................................................o........#
#............O.................o....................o......O............o......#
#..............................................................................#
#..............................................................................#
#..............................................................................#
#..............................................................................#
#..............................................................................#
#.....SSSSSSSSS.................PPPPPPPPPP................SSSSSSSSS............#
#...............................SSSSSSSSSS.....................................#
#...............................SSSSSSSSSS.....................................#
#....................SSSSSSSSSSSSSSSSSSSSSSSSSSSSSS............................#
#....................SSSSSSSSSSSSSSSSSSSSSSSSSSSSSS............................#
#.......PPPPP........SSSSSSSSSSSSSSSSSSSSSSSSSSSSSS.......PPPPP................#
#..............................................................................#
#..............................................................................#
#..............................................................................#
################################################################################

