################################################################################
#..............................................................................#
#..............................................................................#
#.......ggggggggggggg............................ggggggggggggggggggggg.........#
#.......ggggggggggggg............................ggggggggggggggggggggg.........#
#.......ggggggggggggg............................ggggggggggggggggggggg.........#
#.......ggggggggggggg............................ggggggggggggggggggggg.........#
#..............................................................................#
#..............................................................................#
#..............................................................................#
#..............................................................................#
#..............................................................................#
#..............................................................................#
#..............................................................................#
#..............................................................................#
#..............................................................................#
#...............................SSSSSSSSSS.....................................#
#...............................SSSSSSSSSS.....................................#
#...............................SSSSSSSSSS.....................................#
#..............................................................................#
#..............................................................................#
#..............................................................................#
#..............................................................................#
#..............................................................................#
#..............................................................................#
################################################################################
