################################################################################
#..............................................................................#
#..............................................................................#
#....ggggggggggggggggggggggggggggggggggggggggggggggggggggggggggggggggg.........#
#....ggggggggggggggggggggggggggggggggggggggggggggggggggggggggggggggggg.........#
#....ggggggggggggggggggggg...........D...........ggggggggggggggggggggg.........#
#....ggggggggggggggggggggg.......................ggggggggggggggggggggg.........#
#....gggggggggggggggggggggooooooooOOOOOOOooooooooggggggggggggggggggggg.........#
#..............................................................................#
#..............................................................................#
#..............................................................................#
#..............................................................................#
#..............................................................................#
#..............................................................................#
#..............................................................................#
#..............................................................................#
#...............................SSSSSSSSSS.....................................#
#...............................SSSSSSSSSS.....................................#
#...............................SSSSSSSSSS.....................................#
#....................SSSSSSSSSSSSSSSSSSSSSSSSSSSSSS............................#
#....................SSSSSSSSSSSSSSSSSSSSSSSSSSSSSS............................#
#.......PPPPP........SSSSSSSSSSSSSSSSSSSSSSSSSSSSSS.......PPPPP................#
#..............................................................................#
#..............................................................................#
#..............................................................................#
################################################################################
