######################################################
#..2222222222222222222..........2222222222222222222..#
#..2222222222222222222..........2222222222222222222..#
#..2222222222222222222..........2222222222222222222..#
#..2222222222222222222..........2222222222222222222..#
#..2222222222222222222..........2222222222222222222..#
#..2222222222222222222..........2222222222222222222..#
#..2222222222222222222..........2222222222222222222..#
#....................................................#
#....................................................#
#....................................................#
#....................................................#
#....................................................#
#....................................................#
#....................................................#
#....................................................#
#....................................................#
#....................................................#
#....................................................#
#..........11111111111111111111111111111111..........#
#..........11111111111111111111111111111111..........#
#..........11111111111111111111111111111111..........#
#..........11111111111111111111111111111111..........#
#..........11111111111111111111111111111111..........#
#..........11111111111111111111111111111111..........#
#..........11111111111111111111111111111111..........#
#..........11111111111111111111111111111111..........#
######################################################
